32:10:5
1111111211
1000001001
1001101101
1001100001
1000001111
1110000001
1110000001
1000000001
1000101001
1011101101
1001101101
1101101101
1101101101
1000101001
1000000001
1000011101
1101110001
1100000001
1000000001
1111131111