64:20:5
111111111111111111111111111111111111111111111111111
120000000000000000000000000000000000000000000000001
101010101010101010101010101010101010101010101010101
100000000000000000000000000000000000000000000000001
101010101010101010101010101010101010101010101010101
100000000000000000000000000000000000000000000000001
101010101010101010101010101010101010101010101010101
100000000000000000000000000000000000000000000000001
101010101010101010101010101010101010101010101010101
100000000000000000000000000000000000000000000000001
101010101010101010101010101010101010101010101010101
100000000000000000000000000000000000000000000000001
101010101010101010101010101010101010101010101010101
100000000000000000000000000000000000000000000000001
101010101010101010101010101010101010101010101010101
100000000000000000000000000000000000000000000000001
101010101010101010101010101010101010101010101010101
100000000000000000000000000000000000000000000000001
101010101010101010101010101010101010101010101010101
100000000000000000000000000000000000000000000000001
101010101010101010101010101010101010101010101010101
100000000000000000000000000000000000000000000000001
101010101010101010101010101010101010101010101010101
100000000000000000000000000000000000000000000000001
101010101010101010101010101010101010101010101010101
100000000000000000000000000000000000000000000000001
101010101010101010101010101010101010101010101010101
100000000000000000000000000000000000000000000000001
101010101010101010101010101010101010101010101010101
100000000000000000000000000000000000000000000000001
101010101010101010101010101010101010101010101010101
100000000000000000000000000000000000000000000000001
101010101010101010101010101010101010101010101010101
100000000000000000000000000000000000000000000000001
101010101010101010101010101010101010101010101010101
100000000000000000000000000000000000000000000000001
101010101010101010101010101010101010101010101010101
100000000000000000000000000000000000000000000000001
101010101010101010101010101010101010101010101010101
100000000000000000000000000000000000000000000000001
101010101010101010101010101010101010101010101010101
100000000000000000000000000000000000000000000000001
101010101010101010101010101010101010101010101010101
100000000000000000000000000000000000000000000000001
101010101010101010101010101010101010101010101010101
100000000000000000000000000000000000000000000000001
101010101010101010101010101010101010101010101010101
100000000000000000000000000000000000000000000000001
101010101010101010101010101010101010101010101010101
100000000000000000000000000000000000000000000000001
101010101010101010101010101010101010101010101010101
100000000000000000000000000000000000000000000000001
101010101010101010101010101010101010101010101010101
100000000000000000000000000000000000000000000000001
101010101010101010101010101010101010101010101010101
100000000000000000000000000000000000000000000000001
101010101010101010101010101010101010101010101010101
100000000000000000000000000000000000030000000000001
101010101010101010101010101010101010101010101010101
100000000000000000000000000000000000000000000000001
101010101010101010101010101010101010101010101010101
100000000000000000000000000000000000000000000000001
101010101010101010101010101010101010101010101010101
100000000000000000000000000000000000000000000000001
101010101010101010101010101010101010101010101010101
100000000000000000000000000000000000000000000000001
111111111111111111111111111111111111111111111111111