64:60:5
111111111111111000000000001000
121000110000011011011111101010
100011000111011011011000101010
110110010111011000000100100010
110110110100011011110110111010
110000111101111011110110111010
111011100000000011110110111010
111011101101111110000110000010
100001101111111110110111110110
101100100000000000100111110110
101111111111111111101100000110
101100000000001000001101110110
101101110111101011111111110110
101101110001101011100000010110
100000000101101011101111110110
111110111101101011101111110110
100010101101101011101000000110
101110100001001000001011111110
100000101111011111111011100010
101111101111013001111000000010
101000001101110100000011100010
101111111101110111111111111110
100000000001110001100000000000
101111111111110111101101111110
100000000010000001001101111110
111101111111011111011101111110
001101000000001111011100001110
100001111111111111011101110000
111100000000000000011100001111
111111111111111111111111111111
